111111111111111111111111111111111111111111111111111111111111111111111111111
1..........................................11111111111111111111111f..111111
1..........................................11111111111111111111111...111111
1..........................................11111111111111111111111...111111
1......a...................................1111111111111111111...........11
1..........................................1111111111111111111...........11
1..........................................1111111111111111111...........11
11111111111111111111111111111111...........1111111111111111111...........11
11111111111111111111111111111111...........1111111111111111111...........11
11111111111111111111111111111111...........1111111111111111111...........11
11111111111111111111111111111111...........1111111111111111111...........11
11111111111111111111111111111111...........1111111111111111111...........11
11111111111111111111111111111111...........1111111111111111111...........11
11111111111111111111111111111111...........1111111111111111111...........11
11111111111111111111111111111111...........1111111111111111111...........11
11111111111111111111111111111111...........1111111111111111111...........11
11111111111111111111111111111111...........1111111111111111111...........11
11111111111111111111111111111111...........1111111111111111111...........11
111111111111111111.........................1111111111111111111...........11
111111111111111111.........................1111111111111111111...........11
111111111111111111.........................1111111111111111111...........11
111111111111111111.........................1111111111111111111...........11
111111111111111111.........................1111111111111111111...........11
111111111111111111.........................1111111111111111111...........11
111111111111111111.........11111111........1111111111111111111...........11
111111111111111111.........11111111........1111111111111111111...........11
1..........................11111111......................................11
1..........................11111111......................................11
1..........................11111111......................................11
1..........................11111111......................................11
1..........................11111111......................................11
1..........................11111111......................................11
111111111111111111111111111111111111111111111111111111111111111111111111111
