111111111111111111111111111111111111111111111111111111111111111111111111111
111111....................1................11111111111111111111111f..111111
11111......................................11111111111111111111111...111111
11111......................................11111111111111111111111...111111
11111..a.....k............d................1111111111111111111...........11
11111..............1.......................1111111111111111111...........11
111111.....................................1111111111111111111...........11
11111111111111111111111111111111...........1111111111111111111...........11
111111111111111111111111111111111111...11111111111111111111111...........11
11111111111111111111111111111111...........11111111111111111111112222211111
11111111111111111111111111111111.1.......1.1111111111111111111111.....11111
11111111111111111111111111111111d.........d111111111111111111111.......1111
11111111111111111111111111111111.1.......1.111111111111111111111.......1111
11111111111111111111111111111111d.........d11111111111111111111.........111
11111111111111111111111111111111.1.......1.1111111111111111111...........11
11111111111111111111111111111111...........1111111111111111111...........11
111111111111111111111111111111111111...11111111111111111111111...........11
11111111111111111111111111111111...........1111111111111111111...........11
111111111111111111.........................1111111111111111111...........11
111111111111111111.........................1111111111111111111...........11
111111111111111111.........................1111111111111111111...........11
111111111111111111.........................1111111111111111111...........11
111111111111111111.........................1111111111111111111...........11
111111111111111111.........................1111111111111111111...........11
111111111111111111.........11111111........1111111111111111111...........11
111111111111111111.........11111111........1111111111111111111...........11
1..........................11111111......................................11
1..........................11111111......................................11
1..........................11111111......................................11
1..........................11111111......................................11
1..........................11111111......................................11
1..........................11111111......................................11
111111111111111111111111111111111111111111111111111111111111111111111111111
