1111111111111111
1.............11
1.............11
1..a..........11
1.............11
1.............11
1.............11
1.............11
1111111111111111
1111111111111111
