111111111111111111111111111111111111111111111111111111111111111111111111111
1......111111111111111111111111111.........11111111111111111111111f..111111
1..........................................11111111111111111111111...111111
1..a........................c..............11111111111111111111111...111111
1.................c..................11....1111111111111111111...........11
1......11111111111111111111111111111111....1111111111111111111...........11
111111111111111111111111111111111111111....1111111111111111111...........11
111111111111111111111111111111111111111....1111111111111111111...........11
111111111111111111111111111111111111111....1111111111111111111...........11
1111111111111111111111111111111..d...d.....11111111111111111111111222111111
1111111111111111111111111111111.1.1.1.1....11111111111111111111111...111111
1111111111111111111111111111111............11111111111111111111111...111111
1111111111111111111111111111111............1111111111111111111...........11
1111111111111111111111111111111............1111111111111111111.j.........11
1111111111111111111111111111111............1111111111111111111...........11
1111111111111111111111111111111....1.1.1.1.1111111111111111111...........11
1111111111111111111111111111111.....d...d..111111111111111111111111111...11
1111111111111111111111111111111....111111111111111111111111111...........11
1111111111111111111111111111111....111111111111111111111111111...1...1...11
111111111111111............................1111111111111111111....dcd....11
111111111111111.1..........................1111111111111111111....111....11
111111111111111............................1111111111111111111....111....11
111111111111111.1..........................1111111111111111111....d.d....11
111111111111111........11111111111111111...1111111111111111111...1...1...11
111111111111111.1....1.11111111111111111...1111111111111111111...........11
111111111111111.......c11111111111111111...1111111111111111111...1111111111
1......11111111.1....1.11111111111111111...1111111111111111111...1111111111
1d.......1111..........11111111111111111............11...........1111111111
1.......c............1.11111111111111111.......c....11......c....1111111111
1dk...................c11111111111111111.......c....11......c....1111111111
1........1111.c......1.11111111111111111.........................1111111111
1d.....11111111........11111111111111111111111111......c.111111111111111111
111111111111111111111111111111111111111111111111111111111111111111111111111
111111111111111111111111111111111111111111111111111111111111111111111111111
